NNNNNNAANNNNNNAANNNNNNNNNN
NNNNNNAANNNNNNAANNNNNNNNNN
NNLLNNAANNNNNNLLNNLLNNLLNN
NNLLNNAANNNNNNLLNNLLNNLLNN
NNLLNNNNNNNNLLLLNNLLAALLNN
NNLLNNNNNNNNLLLLNNLLAALLNN
NNNNNNLLNNNNNNNNNNAANNNNNN
NNNNNNLLNNNNNNNNNNAANNNNNN
CCNNNNLLNNNNAANNNNLLCCLLAA
CCNNNNLLNNNNAANNNNLLCCLLAA
CCCCNNNNNNLLNNNNAANNCCNNNN
CCCCNNNNNNLLNNNNAANNCCNNNN
NNLLLLLLCCCCCCAANNNNCCLLNN
NNLLLLLLCCCCCCAANNNNCCLLNN
NNNNNNAACCLLNNLLNNLLNNLLNN
NNNNNNAACCLLNNLLNNLLNNLLNN
AALLNNAANNLLNNLLNNNNNNLLNN
AALLNNAANNLLNNLLNNNNNNLLNN
NNLLNNLLNNLLLLLLNNLLAALLNN
NNLLNNLLNNLLLLLLNNLLAALLNN
NNLLNNLLNNLLLLLLNNNNNNNNNN
NNLLNNLLNNNNNNNNNNNNNNNNNN
NNLLNNNNNNLLLLLLNNLLNNLLNN
NNLLNNNNNNLLLLLLNNLLNNLLNN
NNLLNNLLNNLLBBLLNNLLLLLLNN
NNLLNNLLNNLLBBLLNNLLLLLLNN