NNNNNNNNNNNNN
NLNLNLNLNLNLN
NLNLNLNLNLNLN
NLNLNLALNLNLN
NLNLNNNNNLNLN
NNNNNLNLNNNNN
LNLLNNNNNLLNL
NNNNNLNLNNNNN
NLNLNLLLNLNLN
NLNLNLNLNLNLN
NLNLNNNNNLNLN
NLNLNLLLNLNLN
NNNNNLBLNNNNN