NCCNNNNNNNNCN
CCNNNLLNNNNNC
CNNNNNLLLLNNA
ANNLLLLLLLLNN
NNNLNNNLLLNLN
GNNNANANLLNNN
NNNNNNNNLLNGG
NNLLLLLLLLNNN
NNLLLLLLLLLNN
NLLLLLLLLLLNN
NLLNNNNNNLLNC
CNLLNLLLNLNCC
ACNNNLBLNNCCA