NNCCCCNNNNNNNNNNNNNNNNCCNN
NNCCCCNNNNNNNNNNNNNNNNCCNN
CCCCNNNNNNLLLLNNNNNNNNNNCC
CCCCNNNNNNLLLLLLLLNNNNNNCC
CCNNNNNNNNNNLLLLLLLNNNNNAA
CCNNNNNNNNNNLLLLLLLLLLNNNN
AANNNNLLLLLLLLLLLLLLLLNNNN
NNNNNNLLLLLLLLLLLLLLLLLNNN
NNNNNLLLNNNNNNLLLLLLNNLNNN
NNNNNLNNNNNNNNNNLLLLNNLNNN
GGNNNLNNANNNANNNLLLNNNNNNN
GGNNNLNNANNNANNNLLLNNNNNNN
NNNNNLNNNNNNNNNNLLLNNNGGGG
NNNNNLNNLLLLNNNNLLLNNNGGGG
NNNNLLLLLLLLLLLLLLLLNNNNNN
NNNNLLLLLLLLLLLLLLLLNNNNNN
NNNLLLLLLLLLLLLLLLLLLNNNNN
NNNLLLLLLLLLLLLLLLLLLNNNNN
NNLLLLLLLLLLLLLLLLLLLLNNNN
NNNNNNLLLLLLLLLLLLNNNNNNNN
NNLLLLNNNNNNNNNNNNLLLLNNCC
NNLLLLLLNNNNNNNNNNLLLLNNCC
CCNNLLLLNNLLLLLLNNLLNNCCCC
CCNNNNNNNNLLLLLLNNLLNNCCCC
AACCNNNNNNLLBBLLNNNNCCCCAA
AACCNNNNNNLLBBLLNNNNCCCCAA