NNNANNNANNNNN
NLNANNNLNLNLN
NLNNNNLLNLALN
NNNLNNNNNANNN
CNNLNNANNLCLA
CCNNNLNNANCNN
NLLLCCCANNCLN
NNNACLNLNLNLN
ALNANLNLNNNLN
NLNLNLLLNLALN
NLNLNLLLNNNNN
NLNNNLLLNLNLN
NLNLNLBLNLLLN