NNNNNNNNNNNNNNNNNNNNNNNNNN
NNNNNNNNNNNNNNNNNNNNNNNNNN
NNLLNNLLNNLLNNLLNNLLNNLLNN
NNLLNNLLNNLLNNLLNNLLNNLLNN
NNLLNNLLNNLLNNLLNNLLNNLLNN
NNLLNNLLNNLLNNLLNNLLNNLLNN
NNLLNNLLNNLLAALLNNLLNNLLNN
NNLLNNLLNNLLAALLNNLLNNLLNN
NNLLNNLLNNLLNNLLNNLLNNLLNN
NNLLNNLLNNNNNNNNNNLLNNLLNN
NNLLNNLLNNNNNNNNNNLLNNLLNN
NNNNNNNNNNLLNNLLNNNNNNNNNN
NNNNNNNNNNLLNNLLNNNNNNNNNN
LLNNLLLLNNNNNNNNNNLLLLNNLL
AANNLLLLNNNNNNNNNNLLLLNNAA
NNNNNNNNNNLLNNLLNNNNNNNNNN
NNNNNNNNNNLLLLLLNNNNNNNNNN
NNLLNNLLNNLLLLLLNNLLNNLLNN
NNLLNNLLNNLLNNLLNNLLNNLLNN
NNLLNNLLNNLLNNLLNNLLNNLLNN
NNLLNNLLNNLLNNLLNNLLNNLLNN
NNLLNNLLNNNNNNNNNNLLNNLLNN
NNLLNNLLNNLLLLLLNNLLNNLLNN
NNLLNNLLNNLLLLLLNNLLNNLLNN
NNNNNNNNNNLLBBLLNNNNNNNNNN
NNNNNNNNNNLLBBLLNNNNNNNNNN